{
  "id": "level_one",
  "width": 18,
  "layers": [
    [
      63, 40, 40, 40, 40, 40, 40, 40, 40, 40, 40, 40, 40, 40, 40, 40, 40, 40,
      63, 40, 60, 60, 60, 60, 60, 60, 60, 60, 60, 60, 60, 60, 60, 60, 40, 40,
      63, 62, 42, 42, 42, 42, 42, 42, 42, 42, 42, 42, 42, 42, 42, 42, 63, 40,
      63, 62, 43, 43, 43, 43, 43, 43, 43, 43, 43, 43, 43, 43, 43, 43, 63, 40,
      63, 62, 42, 42, 42, 42, 42, 42, 42, 42, 42, 42, 42, 42, 42, 42, 63, 40,
      63, 62, 43, 43, 43, 43, 43, 43, 43, 43, 43, 43, 43, 43, 43, 43, 63, 40,
      63, 62, 42, 42, 42, 42, 42, 44, 42, 42, 42, 42, 42, 42, 42, 42, 63, 40,
      63, 62, 43, 43, 43, 43, 43, 43, 43, 43, 43, 43, 43, 43, 43, 43, 63, 40,
      63, 62, 42, 42, 42, 42, 42, 42, 42, 42, 42, 42, 42, 42, 42, 42, 63, 40,
      63, 62, 43, 43, 43, 43, 43, 43, 43, 43, 43, 43, 43, 43, 45, 43, 63, 40,
      63, 62, 42, 42, 42, 42, 42, 42, 42, 42, 42, 42, 42, 42, 42, 42, 63, 40,
      63, 62, 43, 43, 43, 45, 43, 43, 66, 41, 41, 41, 41, 41, 41, 41, 40, 40
    ],
    [
      63, 40, 40, 40, 40, 40, 40, 40, 40, 40, 40, 40, 40, 40, 40, 40, 40, 40,
      63, 40, 60, 60, 60, 60, 60, 60, 60, 60, 60, 60, 46, 47, 48, 60, 40, 40,
      63, 62, 42, 42, 42, 42, 42, 42, 42, 42, 42, 42, 49, 50, 51, 42, 63, 40,
      63, 62, 43, 43, 43, 43, 43, 43, 43, 43, 43, 43, 52, 53, 54, 43, 63, 40,
      63, 62, 42, 42, 42, 42, 42, 42, 42, 42, 42, 42, 42, 42, 42, 42, 63, 40,
      63, 62, 43, 43, 43, 43, 43, 43, 43, 43, 43, 43, 43, 43, 43, 43, 63, 40,
      63, 62, 42, 42, 42, 42, 42, 44, 42, 42, 42, 42, 42, 42, 42, 42, 63, 40,
      63, 62, 43, 43, 43, 43, 43, 43, 43, 43, 43, 43, 43, 43, 43, 43, 63, 40
    ]
  ],
  "triggers": [
    {
      "position": {
        "x": 12,
        "y": 6
      },
      "type": "teleport",
      "targetRoom": "level_two"
    },
    {
      "position": {
        "x": 6,
        "y": 8
      },
      "type": "unlock",
      "key": "golden_key"
    }
  ],
  "properties": {
    "startingPosX" : 5,
    "startingPosY" : 50,
    "lightEnabled": true
  }
}
